NO textures/matrix.xpm
SO textures/matrix.xpm
WE textures/matrix.xpm
EA textures/matrix.xpm


111111111111111111111
100000000100000000001
100000000000000000001
100000001110000000001
100000010001000000001
100000010000000000001
100000010000000000001
100000001110000000001
100000000000000000001
100000000000010000001
100000000000000000001
100000000000000000001
111111011111111111111
100000000000000000001
100000000001000000001
100000000000000000001
100000000000000000001
100000000000000000001
100000000000000000001
1E0000000000000000001
111111111111111111111
F 0,0,0
C 0,0,0
